#######################
#W     B#M  E  F  E  O#
#       #             #
#E     C#             #
#### ####     T++     #
#       #             #
#       #             #
#       #  C       C  #
#       ####### #######
#                     #
#                     #
### ###      T++mb    #
#    C#              S#
#     #               #
#E  V #               #
#######################
