#######################
#W     B#M  E  F  E  O#
#       #             #
#E     C#             #
#### ####      T      #
#       #             #
#       #             #
#       #  C       C  #
#       ####### #######
#                     #
#                     #
### ###      Tmb      #
#    C#              S#
#     #               #
#EV   #               #
#######################
