###################
#E                #
#                 #
#                 #
#                 #
#                 #
#          ########
#          #
#          ########
#                 #
#                 #
#                 #
#                 #
#                 #
#                 #
#                 #
#                 #
#                 #
#                 #
###################
