#####################
#E   Z    #    Z   E#
#         #         #
#         #         #
#C        #        C#
##### ######### #####
#                   #
#         ######### #
#         #W     C# #
#         #       #S#
#         #       ###
#         #E       B#
#                   #
#####################
